w                                                      www    w
w                                                     w w w   w
w                                                       t     w
w                                                             w
w                                                             w
w                                                         ww  w
w                                                       wwwww w
w                                                     wwwwwwwew
w                                                    w        |
w                                                   w         |
w                                                  w          |
w                                                 w           |
w                                           www ww            |
w                                          w   w              |
w                                         w                   |
ws                                       w                    |
w  w                                    ww                    |
wwwwwww wwwwwwwwwwww  wwwwww  ww  wwwwwwww                    |
