w                       www    w
w                      w   w   w
w                        r     w
w                              w
w                              w
w                         ww   w
w                        wwwwwew
w                      wwwwwwwww
w                     w        |
w                    w         |
w                   w          |
w                  w           |
w            www ww            |
w           w   w              |
w          w                   |
ws        w                    |
w  w     ww                    |
wwww   wwww                    |
