w                                                             w
w                                                             w
w                                                             w
w                                                             w
w                                                             w
w                                                             w
w                                                             w
w                                                             w
w                                                             w
w                                                             w
w                                                             w
w                                                             w
w                                      ww                    ew
w                                  w        w               www
w                              w                          nwwww
w s                       ww                   w          wwwww
w                     w                         w        wwwwww
wwwwwwww    www   w                             wwwwwwwwwwwwwww
