w                                                  www        w
w                                                   i         w
w                                                   t         w
w                                                             w
w                                                             w
w                                                         ww  w
w                                                       wwwww w
w                                                     wwwwwwwew
w                                                    w        |
w                                                   w         |
w                                                  w          |
w                                                 w           |
w                                           www www           |
w                                          w                  |
w                                         w                   |
ws                          ww           w                    |
w  w      w      n w      w     w      ww                     |
wwwwwww wwwwwwwwwwww  wwww        wwwwwwww                    |
