w                                                             w
w                                                             w
w                                                             w
w                                                             w
w                                                             w
w                                                             w
w                                                             w
w                                                             w
w                                                             w
w                                                             w
w                                                             w
w                                                             w
w                                      ww                    ew
w                                  w        w               www
w                              w                           wwww
w s                       ww                   w          wwwww
w                     w                         w      n wwwwww
wwwwwwww    www   w                             wwwwwwwwwwwwwww
