w                                                             w
w                                                             w
w                                                             w
w                                                             w
w                                                             w
w                                                             w
w                                                             w
w                                                             w
w                                                             w
w                                                             w
w                                                             w
w                                  ww                         w
w      w                       ww         w                   w
w      t                   w                                  w
w                        w                      w   ww        w
w s                    ww                   w         w       w
w                 ww                                   w     ew
wwwwwwww   wwww                                        wwwwwwww
