w                                                             w
w                                                             w
w                                                             w
w                                                             w
w                                                             w
w                                                             w
w                                                             w
w                                                             w
w                                                             w
w                                 ww                          w
w                     w      n w      w                       w
w                    wwwwwwwwwww                              w
w                  w                      w                   w
w               w                             ww              w
w           www                                     ww        w
w s      w                                            w       w
w      w                                               w     ew
wwwwwww                                                wwwwwwww
