w                                                             w
w                                                             w
w                                                             w
w                                                             w
w                                                             w
w                                                             w
w                                                             w
w                                  w      n w                 w
w                                 wwwwwwwwwww                 w
w                              w                ww            w
w                            w                                w
w                          w                         w        w
w s                      w                                    w
w                      w                                      w
ww                 www                                 w      w
www            ww                                      w      w
wwww        n w                                        w     ew
wwwwwwwwwwwwwww                                        wwwwwwww
