w                                                             w
w                                                             w
w                                                             w
w                                                             w
w                                                             w
w                                                             w
w                                                             w
w                                                             w
w                                                     w       w
w                                                   w         w
w                                                ww           w
w                     i                       ww              w
w                     t               w  n w                  w
w                                    wwwwwww            w     w
w                                ww                     w     w
w s            w             ww                         w     w
w  w  n   w   www           w                           w    ew
wwwwwwwwwwwwwwwwwwww  wwwwww                            wwwwwww
